김현기 - 웹 앱 경험 
이용현 - 기획? x 지도기반 sns 
김나현 - 디자인 포지션
김지우 - 개발 or 기획 
조건희 - 개발자 
김철연 - 개발자 아두윈 에비매터 백엔 프론트 둘다가능
박창현 - 기획자 
김의제 - 기획 개발 
손하영 - 노력파
김정현 - 디자인가능 
김민성 - 개발 가능
임성빈 - 개발자 가능
신현정 - 디자인 마케터
이택승 - 기획자 드론소프트웨어
김민지 - 기획 디자인 캐드가능 간단한 개발언어 읽을줄암
최수민 - 개발자 코플린 안드로이드언어 쌉가능 ios도 공부중 파이썬 
유헤빈 - 기획자 실시간 검색어 사이트 디자이너 가능
최은선 - ict다중 디자인 마케팅 기획 가능 
김경민 - ict 기획자 음악 영상 미디어 창작 플랫폼
김재한 - 기획자 마케터 
강정한 - 기획자 
정재현 - 기획자
김희원 - 마케터 xxxx
조준형 - 디자인 일러스트 포토샵 개발은 읽는 정도 일리소프트 경험
이득윤 - 3학년 기획 개발 공부시간 기록 어플 개발중 
황규빈 - 기획자 비대면관련 구상중


콜라보 레이션 ex) 민초 
호불호가 있는 음식 아이템 


팀플 양식:
*아이템명: ○○○
1.핵심 고객 분석: 비건 
2. 기존 문제점: 
3. 문제 해결 방법: 
4. 홍보/광고에 들어갈 캐치프레이즈 한 마디:









